19 11
    #####
    #   #
    #o  #
  ###  o##
  #  o o #
### # ## #   ######
#   # ## #####  ..#
# o  o @        ..#
##### ### # ##  ..#
    #     #########
    #######
